w,w,w,w,w,w,d,d
w,w,w,w,w,w,d,d
d,p,d,r,d,d,d,d
d,d,H,d,d,d,d,d
d,d,r,d,d,r,d,d
d,1,d,d,d,d,2,d
d,d,d,d,g,d,d,d