d,d,d,d,d,d,d,d
d,d,d,d,d,d,d,d
d,p,d,r,d,d,d,d
d,d,H,d,d,d,d,d
d,d,r,d,d,r,d,d
d,d,d,d,d,d,d,d
d,d,d,d,g,d,d,d