D,D,D,D,D,D,D
D,D,D,N,N,R,D
D,H,D,D,D,D,D
D,D,D,D,D,D,D
D,D,D,G,D,D,D