d,d,d,d,d,d,d,d
d,d,d,d,d,d,d,d
d,h,d,r,r,d,d,d
d,d,d,d,d,d,d,d
d,d,d,d,d,d,d,d
d,d,d,d,d,d,d,d
d,d,g,d,g,d,d,d
