D,W,D,W,D,W,D
D,N,N,N,N,N,D
D,W,W,H,N,N,D
D,N,N,N,N,N,D
D,D,D,D,D,D,D